SpringBoot	Spring应用快速开发脚手架
MyBatis	持久层ORM框架
MyBatis Dynamic SQL	Mybatis动态sql
PageHelper	MyBatis分页插件
MyBatisGenerator	持久层代码生成插件
Sharding-Jdbc	代码层分库分表中间件
JJWT	JWT登录支持
SpringSecurity	安全框架
Shiro	安全框架
Ehcache	Java进程内缓存框架(默认缓存)
Redis	分布式缓存(缓存替换方案，默认关闭，一行配置开启)
ElasticSearch	搜索引擎(搜索增强方案，默认关闭，一行配置开启)
RabbitMq	消息队列(流量削峰，默认关闭，一行配置开启)
OSS	阿里云对象存储服务(图片存储方式之一，一行配置即可切换)
FastDfs	开源轻量级分布式文件系统(图片存储方式之一，一行配置即可切换)
Redisson	实现分布式锁
Lombok	简化对象封装工具
Docker	应用容器引擎
Mysql	数据库服务
Thymeleaf	模板引擎
Layui	前端UI